Retail	retail	Retail
Sales	sale	Sales
Rise	rise	Rise
a	a	a
Surprise	surpris	Surprise
?.	?.	?.

Is	is	Is
today's	today	today's
big	big	big
retail	retail	retail
news	news	news
a	a	a
surprise	surpris	surprise
?	?	?

Only	onli	Only
for	for	for
those	those	those
who	who	who
weren't	weren't	weren't
paying	pay	paying
attention	attent	attention
.	.	.

