Netflix	netflix	Netflix
Sees	see	Sees
Green	green	Green
.	.	.

Netflix	netflix	Netflix
spins	spin	spin
the	the	the
color	color	color
wheel	wheel	wheel
for	for	for
a	a	a
spell	spell	spell
and	and	and
it's	it	it's
a	a	a
much	much	much
brighter	brighter	brighter
color	color	color
than	than	than
red	red	red
.	.	.

