AmEx	amex	AmEx
wants	want	want
rivals	rival	rival
to	to	to
pay	pay	pay
.	.	.

Now	now	Now
the	the	the
credit	credit	credit
-	-	-
card	card	card
companies	compani	company
are	are	are
trying	tri	trying
to	to	to
tack	tack	tack
on	on	on
billions	billion	billion
in	in	in
charges	charg	charge
to	to	to
each	each	each
other	other	other
.	.	.

American Express Co.	american express co.	American Express Co.
wants	want	want
rivals	rival	rival
Visa USA Inc.	visa usa inc.	Visa USA Inc.

