Birding	bird	Birding
Column	column	Column
:	:	:
Backyard	backyard	Backyard
Bathing	bath	Bathing
Beauties	beauti	Beauties
.	.	.

Birder	birder	Birder
Mathew	mathew	Mathew
Tekulsky	tekulski	Tekulsky
describes	describ	describes
the	the	the
bathing	bath	bathing
habits	habit	habit
of	of	of
birds,	birds,	birds,
explaining	explain	explaining
the	the	the
dependence	depend	dependence
of	of	of
birds	bird	bird
on	on	on
water	water	water
.	.	.

