AT	at	AT
T	t	T
strikes	strike	strike
VoIP	voip	VoIP
deals	deal	deal
with	with	with
cable	cabl	cable
.	.	.

Company	compani	Company
points	point	point
potential	potenti	potential
Net	net	Net
phone	phone	phone
customers	custom	customer
to	to	to
cable	cabl	cable
giants	giant	giant
for	for	for
broadbandall	broadbandal	broadbandall
part	part	part
of	of	of
Ma	ma	Ma
Bell's	bell	Bell's
aggressive	aggress	aggressive
VoIP	voip	VoIP
plans	plan	plan
.	.	.

