Global	global	Global
lessons	lesson	lesson
in	in	in
e	e	e
-	-	-
voting	vote	voting
.	.	.

India	india	India
reports	report	report
success,	success,	success,
while	while	while
Venezuela	venezuela	Venezuela
fears	fear	fear
fraud	fraud	fraud
.	.	.

What	what	What
can	can	can
the	the	the
United	unit	United
States	state	States
learn	learn	learn
?	?	?

