Limited	limit	Limited
black	black	black
rhino	rhino	rhino
hunt	hunt	hunt
approved	approv	approved
.	.	.

Namibiaand	namibiaand	Namibiaand
South	south	South
Africa	africa	Africa
are	are	are
told	told	told
at	at	at
a	a	a
Bangkok	bangkok	Bangkok
summit	summit	summit
they	they	they
can	can	can
each	each	each
kill	kill	kill
five	five	five
endangered	endang	endangered
black	black	black
rhinos	rhino	rhino
per	per	per
year	year	year
.	.	.

