Antarctic	antarct	Antarctic
food	food	food
web	web	web
under	under	under
threat	threat	threat
.	.	.

The	the	The
shrimp	shrimp	shrimp
-	-	-
like	like	like
krill	krill	krill
that	that	that
feed	feed	feed
so	so	so
many	mani	many
Antarctic	antarct	Antarctic
species,	species,	species,
such	such	such
as	as	a
whales	whale	whale
and	and	and
penguins,	penguins,	penguins,
is	is	is
in	in	in
big	big	big
decline,	decline,	decline,
say	say	say
researchers	research	researcher
.	.	.

