Lloyd	lloyd	Lloyd
Braun's	braun	Braun's
doppelganger	doppelgang	doppelganger
.	.	.

New	new	New
Yahoo	yahoo	Yahoo
exec's	exec	exec's
name	name	name
ring	ring	ring
a	a	a
bell	bell	bell
?	?	?

Maybe	mayb	Maybe
you've	you'v	you've
been	been	been
watching	watch	watching
Seinfeld	seinfeld	Seinfeld
reruns	rerun	rerun
.	.	.

Missing	miss	Missing
Links	link	Links

