W3C	w3c	W3C
highlights	highlight	highlight
Mobile	mobil	Mobile
Web	web	Web
Initiative	initi	Initiative
at	at	at
workshop	workshop	workshop
.	.	.

Group	group	Group
seeks	seek	seek
to	to	to
make	make	make
Web	web	Web
access	access	access
for	for	for
mobile	mobil	mobile
device	devic	device
users	user	user
as	as	a
easy	easi	easy
as	as	a
it	it	it
is	is	is
for	for	for
desktop	desktop	desktop
users	user	user
.	.	.

