Quest	quest	Quest
for	for	for
holy	holi	holy
grail	grail	grail
of	of	of
game	game	game
controllers	control	controller
.	.	.

The	the	The
quest	quest	quest
for	for	for
a	a	a
wireless,	wireless,	wireless,
robust	robust	robust
video	video	video
game	game	game
controller	control	controller
is	is	is
a	a	a
hit	hit	hit
and	and	and
miss	miss	miss
task	task	task
.	.	.

