EU	eu	EU
Cannot	cannot	Cannot
Start	start	Start
Entry	entri	Entry
Talks	talk	Talks
With	with	With
Turkey	turkey	Turkey
Unless	unless	Unless
it	it	it
Reforms	reform	Reforms
Penal	penal	Penal
&lt	&lt	&lt
;	;	;
b&gt	b&gt	b&gt
;..	;..	;..
.	.	.
&lt	&lt	&lt
;	;	;
/b&gt	/b&gt	/b&gt
;.	;.	;.

The	the	The
European	european	European
Union	union	Union
has	has	ha
made	made	made
clear	clear	clear
to	to	to
Turkey	turkey	Turkey
that	that	that
it	it	it
cannot	cannot	cannot
start	start	start
negotiations	negoti	negotiation
on	on	on
joining	join	joining
the	the	the
union,	union,	union,
until	until	until
Ankara	ankara	Ankara
reforms	reform	reform
its	it	it
penal	penal	penal
code	code	code
.	.	.

