Semi	semi	Semi
heat	heat	heat
breeze	breez	breeze
for	for	for
Jones,	jones,	Jones,
US	us	US
.	.	.

ATHENS	athen	ATHENS
Marion	marion	Marion
Jones	jone	Jones
returned	return	returned
to	to	to
the	the	the
Olympic	olymp	Olympic
track	track	track
last	last	last
night	night	night
to	to	to
do	do	do
what	what	what
she	she	she
does	doe	doe
best	best	best
sprint	sprint	sprint
.	.	.

