Yanks	yank	Yanks
Crush	crush	Crush
Red	red	Red
Sox.	sox.	Sox.

Gary	gari	Gary
Sheffield,	sheffield,	Sheffield,
Derek	derek	Derek
Jeter	jeter	Jeter
and	and	and
Jorge	jorg	Jorge
Posada	posada	Posada
each	each	each
homer	homer	homer
off	off	off
Pedro	pedro	Pedro
Martinez,	martinez,	Martinez,
and	and	and
the	the	the
Yankees	yanke	Yankees
rout	rout	rout
the	the	the
Red	red	Red
Sox	sox	Sox
11	11	11
-	-	-
1	1	1
on	on	on
Sunday	sunday	Sunday
.	.	.

