Gators	gator	Gators
gag	gag	gag
on	on	on
Bulldog	bulldog	Bulldog
.	.	.

You	you	You
could	could	could
rattle	rattl	rattle
off	off	off
the	the	the
statistics,	statistics,	statistics,
one	one	one
after	after	after
another,	another,	another,
as	as	a
the	the	the
growing	grow	growing
list	list	list
of	of	of
baffling	baffl	baffling
facts	fact	fact
begins	begin	begin
to	to	to
define	defin	define
the	the	the
repulsiveness	repuls	repulsiveness
of	of	of
this	this	this
defeat	defeat	defeat
.	.	.

