How	how	How
Much	much	Much
Will	will	Will
Moss	moss	Moss
Play	play	Play
?.	?.	?.

After	after	After
playing	play	playing
only	onli	only
two	two	two
downs	down	down
last	last	last
Sunday	sunday	Sunday
against	against	against
Tennessee,	tennessee,	Tennessee,
Randy	randi	Randy
Moss	moss	Moss
will	will	will
get	get	get
another	anoth	another
opportunity	opportun	opportunity
to	to	to
increase	increas	increase
his	his	his
role	role	role
against	against	against
the	the	the
Giants	giant	Giants
.	.	.

